2 2 2 2 2 2 2 2 2 2 2 2 2 2 2 2 2 2 2 2 2 2 2 2 2 2 2 2 2 2 2
2 2 2 2 2 2 2 2 2 2 2 2 2 2 2 2 2 2 2 2 2 2 2 2 2 2 2 2 2 2 2
2 2 2 2 2 2 2 2 2 2 2 2 2 2 2 2 2 2 2 2 2 2 2 2 2 2 2 2 2 2 2
5 5 5 5 5 5 5 5 5 5 5 4 4 5 5 5 5 5 5 5 5 5 5 5 5 5 5 5 5 5 5
5 0 0 0 0 5 0 0 0 0 5 4 4 5 5 5 5 5 5 5 5 5 5 5 5 5 5 0 0 0 5
5 0 0 0 0 5 0 0 0 0 5 4 4 5 5 5 5 5 5 5 5 5 5 5 5 5 5 4 4 4 5
5 0 0 0 0 5 0 0 0 0 5 4 4 5 1 0 0 0 0 0 0 0 0 0 4 5 5 0 0 0 5
5 0 0 0 0 5 5 0 5 5 5 4 4 5 1 0 0 0 0 0 0 0 0 0 4 5 5 0 0 0 5
5 0 0 0 0 0 0 0 0 0 5 0 0 5 1 2 2 2 2 2 2 2 2 2 4 5 5 0 0 0 5
5 0 0 0 0 0 0 0 0 0 5 0 0 5 1 2 2 2 2 2 2 2 2 2 4 5 5 0 0 0 5
5 0 0 0 0 0 0 0 0 0 0 0 0 5 1 0 0 0 0 0 0 0 0 0 4 5 5 0 0 0 5
5 0 0 0 0 0 0 0 0 0 0 0 0 5 1 0 0 0 0 0 0 0 0 0 4 5 5 0 0 0 5
5 0 0 0 0 0 0 0 0 0 0 0 0 5 5 5 5 5 5 5 5 5 5 5 5 5 5 0 0 0 5
5 5 5 5 5 5 5 5 5 5 5 5 5 5 5 5 5 5 5 5 5 5 5 5 5 5 5 5 5 5 5